# #######
#       #
# # # # #
#  ## # #
# #  ## #
# # #   #
# # # ###
# #   # #
# ####  #
#     # #
##### # #
#       #
## ## # #
####### #
